US,USA,46,29,29,104
China,CHN,38,27,23,88
Russia,RUS,24,26,32,82
UK,GBR,29,17,19,65
Germany,GER,11,19,14,44
France,FRA,11,11,12,34
Japan,JPN,7,14,17,38
Australia,AUS,7,16,12,35
South Korea,KOR,13,8,7,28
Italy,ITA,8,9,11,28
Netherlands,NED,6,6,8,20
Hungary,HUN,8,4,5,17
Ukraine,UKR,6,5,9,20
Spain,ESP,3,10,4,17
Brazil,BRA,3,5,9,17
Kazakhstan,KAZ,7,1,5,13
Cuba,CUB,5,3,6,14
New Zealand,NZL,6,2,5,13
Canada,CAN,1,5,12,18
Iran,IRI,4,5,3,12
Jamaica,JAM,4,4,4,12
Belarus,BLR,2,5,5,12